{
  "0": "97",
  "1": "98",
  "2": "99",
  "3": "100",
  "4": "101",
  "5": "102",
  "6": "103",
  "7": "104",
  "8": "105",
  "9": "106",
  "10": "107",
  "11": "108",
  "12": "109",
  "13": "110",
  "14": "111",
  "15": "112",
  "16": "113",
  "17": "114",
  "18": "115",
  "19": "116",
  "20": "117",
  "21": "118",
  "22": "119",
  "23": "120",
  "24": "121",
  "25": "122",
  "26": "45",
  "27": "65",
  "28": "66",
  "29": "67",
  "30": "68",
  "31": "69",
  "32": "70",
  "33": "71",
  "34": "72",
  "35": "73",
  "36": "74",
  "37": "75",
  "38": "76",
  "39": "77",
  "40": "78",
  "41": "79",
  "42": "80",
  "43": "81",
  "44": "82",
  "45": "83",
  "46": "84",
  "47": "85",
  "48": "86",
  "49": "87",
  "50": "88",
  "51": "89",
  "52": "90",
  "53": "95",
  "54": "36",
  "55": "37",
  "56": "40",
  "57": "41",
  "58": "46",
  "59": "58",
  "60": "48",
  "61": "49",
  "62": "50",
  "63": "51",
  "64": "52",
  "65": "53",
  "66": "54",
  "67": "55",
  "68": "56",
  "69": "57"
}
